0000000000000000000000000000000000000000000
0000000000000000000000000000000000000000000
0000000000000000000000111100000000000000000
0000000000000000000000000000000000000000000
0000000000001111111110000000000000000000000
0000000000000000000000000000000000000000000
0000000000000000001111111000000000000000000
0000000000000000000000000000000000000000000
0000000000000000000000000000000000000000000
1110011100000000000000111111111111111111111
0000000000111111110000000000000000000000000
0000000000000000000000000000000000000000000
0000000000000000001111100000000000000000000
0000000000000000000000000000000000000000000
0000000000000000000000000111000110000000000
0000000001110000000000000000000000000000000
0000000000000000000000000000000001100000000
0000000000000000000000000000000000000000000
0000001111111111111110000000001100000000000
0000000000000000000000000000000000000000000
0000000000001000000000000001100000000000000
0000000001000000000000000000000000000000000
0000000000000001111111111111000000000000000
0000001000000000000000000000000000000000000
0000000000000000000000000111111111111111111
0000001100000000000000000000000000000000000
0000000000000000000000111111111111110000000
0000000000000000000000000000000000000000000
0000011111111111111100000000000000000000000
0000000000000000000000000000000000000000000
0000000000000000000011111111111000000000000
0000000000000000000000000000000000000000000
0000000000000000000000000000000011111111111
0000000000000000000000000000000000000000000
1111111111111111111111111111111111111111111
