0000000000000000000000000000000000000000000
0000000000000000000000000000000000000000000
0000000000000000000000000000000000000000000
0000000000000000000000000000000000000000000
0000000000001111110000000000000000000000000
0000000000000000000000000000000000000000000
0000000000000000001111111000000000000000000
0000000000000000000000000000000000011100000
0000000000000000000000000000000000000000000
0000000000000000000000000011111110000000000
0000000000000000000000000000000000000000000
0000000000000000011100000000000000000000000
0000000001111000000000000000000000000000000
0000000000000000000000000000000000000000000
0000111000000000000000000111000110000000000
0000000000000000000000000000000000000000000
0000000000011100000000000000000001100000000
0000000000000000000000000000000000000000000
0000000000000000011110000000000000000000000
0000000000000000000000110000000000000000000
0000000000000000000000000001100000000000000
0000000000000000000000000000000011110000000
0000000000000000000000000000111100000000000
0000000000000000000000001111000000000000000
0000000011111110000000000000000000000000000
0000000000000000000000000000000000000000000
0000000000000000000000000100000000000000000
0000000000000000000000000000000000000000000
0000011111111111111100000000000010000000000
0000000000000000000000000000000000000000000
0000000000000000000000000010000000000000000
0000000000000000000000000000000000100000000
0000000000000000000000000000000000000000001
0000000000000000000000000000000000000000000
1111111111111111111111111111111111111111111
