0000000000000000000000000000000000000000000
0000000000000000000000000000000000000000000
0000000000000000000111110000000000000000000
0000000000000000000000000000000000000000000
0000000000000000010000000100000000000000000
0000000000000000000000000000000000000000000
0000000000000111000000000001110000000000000
0000000000000000000000000000000000000000000
0000011111000000000000000000000001111100000
0000000000000000000000000000000000000000000
0000000000000111000000000001110000000000000
0000000000000000000000000000000000000000000
0000000000000000010000000100000000000000000
0000000000000000000000000000000000000000000
0000000000000000000111110000000000000000000
0000000000000000000000000000000000000000000
0000000000000000010000000100000000000000000
0000000000000000000000000000000000000000000
0000000000000111000000000001110000000000000
0000000000000000000000000000000000000000000
0000011111000000000000000000000001111100000
0000000000000000000000000000000000000000000
0000000000000111000000000001110000000000000
0000000000000000000000000000000000000000000
0000000000000000010000000100000000000000000
0000000000000000000000000000000000000000000
0000000000000000000111110000000000000000000
0000000000000000000000000000000000000000000
0000000000000000010000000100000000000000000
0000000000000000000000000000000000000000000
0000000000000111000000000001110000000000000
0000000000000000000000000000000000000000000
0000011111000000000000000000000001111100000
0000000000000000000000000000000000000000000
1111111111111111111111111111111111111111111
