0000000000000000000000000000000000000000000
0000000000000000000000000000000000000000000
1111100000000000000000000000000000000000000
0000000000000000000000000001111111111100000
0000000000000000000000000000000000000000000
0000000111111111111100000000000000000000000
1000000000000000000000000000011000000000000
1000000000000000000000000000000000000000000
1000000000000000000000000000000000000000000
1000000000000000000000000000000000000111111
1000000000000001111111111000000000000000000
1000000000000000000000000000000000000000000
1110000001000000000000000000001110000000000
0000000000000000000000000000000000000000000
0000000000000000000000000000000000000000111
0000000000000000000000000000000000000000000
0000000000000000000000000000000000000000000
0000001111111111100000000011111111110000000
1000000000000000000000000000000000000000000
1000000000000000000000000000000000000000000
1000000000000000000000000000000000000000000
1000000000000000000000000000000000000000000
1000000000000000000000000000000000000000000
1000000000000000000000000000000000000000000
1000000000000000000000000000000000000000000
0000000000000000000000000000000000000000000
0000000000000000000000000000000000000000000
1111111111110000000000000011110000000000000
0000000000000000001100000000000000000000000
0000000000000000000000000000000000000000000
0000000000000000000000000000000000111111111
0000000000000000000000000000000000000000000
0000000000000000000000000000000000000000000
0000000000000000000000000000000000000000000
1111111111111111111111111111111111111111111
