0000000000000000000000000000000000000000000
0000000000000000000000000111100000000000000
0000000000000000000000000000000000000000000
0000000000000000000000000000000000000000000
0000000000001111111111111110000000000000000
0000000000000000000000000000000000000000000
0000000000000000000000000000000000000000000
0000000000000000000000000000011111100000000
1111111110000000000000000000000000000000000
0000000000000000111111110000000000000000000
0000000000000000000000000000000000000000000
0001111111111000000000000000001111111110000
0000000000000000000000000000000000000000000
0000000000000000000000000000000000000000000
0000000000000111111111000000000000011111111
0000000000000000000000000000000000000000000
0000000000000000000000000000000000000000000
0000000000000000000000001111111111100000000
0000000000000000000000000000000000000000000
0000000000000000000000000000000000000000000
0000000000000000111111110000000000000000000
0000000000000000000000000000000000000111111
0000000000000000000000000000000000000000000
0000001111111110000000011111111000000000000
0000000000000000000000000000000000000000000
0000000000000000000000000000000000000000000
1111100000000000000000000000000000000000000
0000000000000000000000000000000000000000000
0000000000000000000000000000000000011111111
0000000001111111111000000001100000000000000
0000000000000000000000000000000000000000000
0000000000000000000000000000000000000000000
0000000000000000001111111111111111000000000
0000000000000000000000000000000000000000000
1111111111111111111111111111111111111111111
